MPS Guardia リージョナルサービスレポート=รายงานบริการระดับภูมิภาคของ MPS Guardia
目次=สารบัญ
月次サマリー=บทสรุปผู้บริหาร
サービスレベル=ระดับการบริการ
出力面数=ปริมาณการพิมพ์
インシデント=เหตุการณ์
新規発見出力機器=อุปกรณ์เอาท์พุทใหม่
Guardia指標=ตัวชี้วัดการบริการ
出力状況分析=การวิเคราะห์เอาท์พุทการพิมพ์
機能別利用状況=การใช้งานตามคุณสมบัติ
合計=รวม
カラー出力=ปริมาณการใช้สี
報告項目=รายการรายงาน
目標値/参考値=เป้าหมาย
結果=ค่าจริง
時間内一次対応率=อัตราการตอบสนองตรงเวลา
時間内解決率=อัตราการแก้ไขปัญหาตรงเวลา
モノクロ=ขาว-ดำ
モノクロ出力=ปริมาณการใช้ขาว-ดำ
コメント=ข้อสังเกตที่สำคัญและแนวโน้ม
ページあたりのコスト=ยอดค่าใช้จ่ายต่อหน้า
1人あたりのコスト=ยอดค่าใช้จ่ายต่อพนักงาน
1人あたりの出力面数=ปริมาณการพิมพ์ต่อพนักงาน
機器1台あたりの従業員数=จำนวนพนักงานต่ออุปกรณ์
平均稼働率=อัตราการใช้งานเฉลี่ย
インシデント対応=ฝ่ายสนับสนุนการบริการ
N-up比率=อัตราส่วนการใช้แบบ N-up
両面比率=อัตราส่วนการใช้แบบ 2 ด้าน
カラー比率=อัตราส่วนการใช้สี
コピー=\u0000ทำสำเนา
プリント=พิมพ์
スキャン=\u0001สแกน
ファクス受信=รับแฟกซ์
ファクス送信=ส่งแฟกซ์
紙の種類別利用状況=การใช้งานตามชนิดกระดาษ
その他=อื่นๆ
SLA項目=SLA
SLA目標=เป้าหมาย
実績値=ค่าจริง
SLA達成=บรรลุตาม SLA หรือไม่
SLA達成\r\nインシデント数=จำนวนเหตุการณ์ที่บรรลุตาม SLA
SLA対象\r\nインシデント数=จำนวนเหตุการณ์ที่รวมอยู่ใน SLA
カラー出力面数 月度推移=แนวโน้มของปริมาณการใช้สี
モノクロ出力面数 月度推移=แนวโน้มของปริมาณการใช้ขาว-ดำ
他社機=ยอดรวมของอุปกรณ์จากบริษัทอื่น
本年度=ปีปัจจุบัน
前年度=ปีก่อนหน้า
基準面数=เกณฑ์พื้นฐาน
1月=ม.ค.
2月=ก.พ.
3月=มี.ค.
4月=เม.ย.
5月=พ.ค.
6月=มิ.ย.
7月=ก.ค.
8月=ส.ค.
9月=ก.ย.
10月=ต.ค.
11月=พ.ย.
12月=ธ.ค.
別 出力面数 レポート=ปริมาณการพิมพ์ตาม
機器=จำนวนอุปกรณ์
従業員数=จำนวนพนักงาน
モノクロコスト=ยอดค่าใช้จ่ายของการใช้ขาว-ดำ
カラーコスト=ยอดค่าใช้จ่ายของการใช้สี
総出力=ปริมาณการพิมพ์รวม
総コスト=ยอดค่าใช้จ่ายรวม
月次基準=เกณฑ์พื้นฐาน
別 出力面数=ปริมาณการพิมพ์ตาม
別 総出力面数 月度推移=แนวโน้มของปริมาณการพิมพ์ตาม
別 出力面数 月度推移 テーブル=ปริมาณการพิมพ์ตามเดือนและ
分類=ประเภท
別 Guardia指標=ตัวชี้วัดการบริการตาม
１人あたりの出力面数=ปริมาณการพิมพ์ต่อพนักงาน
稼働率{0}％以上機器=จำนวนอุปกรณ์ที่มีอัตราการใช้งาน \u2265{0}%
稼働率=อัตราการใช้งาน
月次基準値=เกณฑ์พื้นฐาน
稼働率{0}％以上の機器一覧=อุปกรณ์ที่มีอัตราการใช้งาน \u2265{0}%
事業所名=ออฟฟิศ
設置場所=ตำแหน่งที่ตั้ง
アセット番号=หมายเลขสินทรัพย์
機種名=รุ่น
実施日=วันที่บันทึก
MACD区分=ประเภท MACD
移動前設置場所=ตำแหน่งที่ตั้งก่อนหน้า
{0}面={0} หน้า
{0}円={0} JPY
{0}人={0} คน
{0}件={0} เคส
{0}台={0} รายการ
{0}枚={0} แผ่น
インシデント区分=ประเภทเหตุการณ์
インシデント数=จำนวนเหตุการณ์
インシデント対応者=เหตุการณ์ตามกลุ่มตัวแก้ปัญหา
割合=การกระจายข้อมูล
インシデント事象=เหตุการณ์ตามประเภทของปัญหา
コピー質=คุณภาพรูป
紙詰まり=กระดาษติด
機械動作=การใช้งานเครื่อง
ネットワーク=เครือข่าย
原稿送り=การป้อนเอกสาร
エラーコード=รหัสข้อผิดพลาด
FAX送受信=การส่งแฟกซ์
オプション=ตัวเลือก
点検依頼=คำขอบำรุงรักษา
異臭=กลิ่น
その他故障=อื่นๆ
インシデントの一覧=รายการเหตุการณ์
インシデント番号=หมายเลขเหตุการณ์
発生日時=วันที่และเวลาของการเกิดเหตุการณ์
一次対応日時=วันที่และเวลาของการตอบสนองครั้งแรก
解決日時=วันที่และเวลาของการแก้ไขปัญหา
機械番号=หมายเลขผลิตภัณฑ์
プロアクティブ対応=การตอบสนองเชิงรุก
SLA達成（時間内一次対応）=บรรลุตาม SLA (ตอบสนองครั้งแรกตรงเวลา)
SLA達成（時間内解決）=บรรลุตาม SLA (แก้ไขปัญหาตรงเวลา)
発見日付=วันที่พบ
IPアドレス=ที่อยู่ IP
別 出力状況レポート N-up/両面/カラー 比率=การวิเคราะห์เอาท์พุทการพิมพ์ตามอัตราส่วนของ N-up / 2 ด้าน / สี
単位:%=%
別 N-up比率 月度推移=แนวโน้มอัตราส่วนการใช้แบบ N-up ตาม
別 N-up比率 月度推移 テーブル=แนวโน้มอัตราส่วนการใช้แบบ N-up ตาม
別 両面比率 月度推移=แนวโน้มอัตราส่วนการใช้แบบ 2 ด้านตาม
別 両面比率 月度推移 テーブル=แนวโน้มอัตราส่วนการใช้แบบ 2 ด้านตาม
別 カラー比率 月度推移=แนวโน้มอัตราส่วนการใช้สีตาม
別 カラー比率 月度推移 テーブル=แนวโน้มอัตราส่วนการใช้สีตาม
別 機能別利用状況=การใช้งานตามคุณสมบัติตาม
別 紙の種類別利用状況=การใช้งานตามชนิดกระดาษตาม
機器ごとのご利用状況一覧=รายละเอียดการใช้งานตามอุปกรณ์
稼働率集計対象外=ไม่รวมอยู่ในการคำนวณอัตราการใช้งาน
状況分析=การวิเคราะห์เอาท์พุทการพิมพ์
各機能別利用面数=การใช้งานที่ใช้ไปตามคุณสมบัติ
紙の種類別利用枚数=จำนวนแผ่นที่ใช้ไปตามชนิดกระดาษ
MPS Guardiaレポート=รายงานบริการของ MPS Guardia
富士フイルムビジネスイノベーションジャパン株式会社=บริษัท ฟูจิฟิล์ม บิสซิเนส อินโนเวชั่น จำกัด
※本レポートの枚数および金額は実際の請求額とは若干異なりますことをご了承ください。=หมายเหตุ: ปริมาณการพิมพ์ที่อยู่ในรายงานนี้อาจแตกต่างไปจากยอดที่เรียกเก็บเงินจริง
はじめに：本レポートの集計期間は「{0} - {1}」です=ข้อมูลรายงานจาก {0} ถึง {1}
年間基準印刷面の月間換算=ค่าเกณฑ์พื้นฐาน
今月の稼働実績を報告します。=เราจะรายงานผลการใช้งานของเดือนนี้
※ お客様から翌々営業日以降にインシデント対応の日時を指定された場合、\r\n    そのインシデントはSLA対象に含みません。=เหตุการณ์ที่ลูกค้าขอให้ดำเนินการแก้ไขปัญหา\r\nหลังจากวันทำการถัดไปจะไม่ถูกรวมอยู่ใน SLA
通常営業時間内にスコープ内の出力機器が正常稼動している時間の割合。=อัตราส่วนของเวลาซึ่งอุปกรณ์ที่อยู่ในขอบเขตนั้นอยู่ในสถานะพร้อมใช้ (สำหรับการใช้งาน) ภายในช่วงเวลาทำการปกติ\r\nอุปกรณ์ที่อยู่ในขอบเขตจะอยู่ในสถานะพร้อมใช้งานเมื่อลูกค้าสามารถใช้งานพื้นฐานต่างๆ ได้ (รวมถึงการพิมพ์, ทำสำเนา, สแกน และ/หรือ แฟกซ์)
通常営業時間内において、サービス要求への対応を基準時間内に開始したインシデントの割合。=เวลาที่ใช้ (ในช่วงเวลาทำการปกติ) ของศูนย์บริการในการตอบสนองต่ออุปกรณ์ที่อยู่ในขอบเขตและมีข้อผิดพลาด\r\nโดยวัดจากเวลาที่ตั๋วได้รับการบันทึกไปจนถึงเวลาที่แผนกให้ความช่วยเหลือทำการตอบสนองต่อเหตุการณ์
通常営業時間内において、出力機器の故障を基準期限までに復旧したインシデントの割合。=เวลาที่ใช้ (ในช่วงเวลาทำการปกติ) ของฝ่ายสนับสนุนจาก FUJIFILM BI เพื่อแก้ไขเหตุการณ์\r\nโดยวัดจากเวลาที่ตั๋วได้รับการบันทึกไปจนถึงเวลาที่ฝ่ายสนับสนุนทำการแก้ไขเหตุการณ์
各計算ロジックは以下の通りです。=วิธีการคำนวณมีดังต่อไปนี้:
N-up比率：N-up枚数÷全枚数=อัตราส่วนการใช้แบบ N-up: จำนวนแผ่นแบบ N-up ÷ จำนวนแผ่นทั้งหมด
両面比率：両面枚数÷全枚数=อัตราส่วนการใช้แบบ 2 ด้าน: จำนวนแผ่นแบบ 2 ด้าน ÷ จำนวนแผ่นทั้งหมด
カラー比率：カラー面数÷全面数=อัตราส่วนการใช้สี: จำนวนภาพสี ÷ จำนวนภาพทั้งหมด
平均より良いスコアは=คะแนนดีกว่าค่าเฉลี่ย คือ
青色=สีฟ้า
平均より悪いスコアは=คะแนนแย่กว่าค่าเฉลี่ย คือ
赤色=สีแดง
平均=ค่าเฉลี่ย
レポートの生成=รอบระยะเวลาการรายงาน
セキュリティレポート=รายงานด้านความปลอดภัย
セキュリティレポートサマリ=สรุปรายงานด้านความปลอดภัย
報告対象期間：=รอบระยะเวลาการรายงาน:
報告対象期間における是正状況は以下の通りです。=เหตุการณ์ที่ได้รับการแก้ไข/ไม่ได้รับการแก้ไขในรอบระยะเวลาการรายงาน มีดังต่อไปนี้:
時間内に是正できなかったインシデントの件数=จำนวนเหตุการณ์ด้านความปลอดภัยที่แก้ไขไม่ทันเวลา
侵入されない=ป้องกันการแฮกข้อมูล
のぞかれない=ป้องการกันสอดแนมข้อมูล
書き換えられない=ป้องกันการขโมยข้อมูล
設定項目=การตั้งค่าความปลอดภัย
時間内是正インシデント数=จำนวนเหตุการณ์ที่แก้ไขได้
是正対象インシデント数=จำนวนเหตุการณ์ด้านความปลอดภัย
ユーザ認証と権限=การรับรองความถูกต้องผู้ใช้และสิทธิ์
管理機能の保護=การปกป้องการควบคุมงานดูแลจัดการ
制御SW最新化=การอัปเดตซอฟต์แวร์การควบคุม
不要なネットワークの停止=การหยุดชะงักของเครือข่ายที่ไม่ปกติ
通信データの保護=การปกป้องข้อมูลการสื่อสาร
デバイス内保存文書の保護=การปกป้องไฟล์ที่บันทึกไว้ในอุปกรณ์
設定や操作のミスを防止=การป้องกันข้อผิดพลาดในการตั้งค่าและการใช้งาน
複合機ソフトウェアの保護=การปกป้องซอฟต์แวร์อุปกรณ์มัลติฟังก์ชัน
ログの管理と保護=การจัดการบันทึกและการป้องกัน
セキュリティ設定変更履歴=ประวัติการเปลี่ยนแปลงการตั้งค่าความปลอดภัย
セキュリティ設定項目=การตั้งค่าความปลอดภัย
グループ=กลุ่ม
期待値=ค่าที่แนะนำ
変更区分=ประเภทการเปลี่ยน
変更値=ค่าใหม่
変更日=วันที่เปลี่ยน
是正日=วันที่แก้ไข
デバイス側=อุปกรณ์
設定側=การตั้งค่า
通貨単位:=หน่วยสกุลเงิน:
円=JPY
案件登録=การลงทะเบียนข้อตกลง
アセット登録=การลงทะเบียนสินทรัพย์
MACD依頼=คำขอ MACD
操作問合せ依頼=การสอบถามเกี่ยวกับการใช้งานอุปกรณ์
その他問合せ依頼=การสอบถามอื่นๆ ของลูกค้า
修理点検依頼=คำขอตรวจสอบและซ่อมแซม
機器検知 障害=ตรวจหาความล้มเหลว
消耗品依頼=สั่งซื้อวัสดุสิ้นเปลือง
機器検知 消耗品=ตรวจหาการสั่งซื้อวัสดุสิ้นเปลือง
機器検知 ディスカバリ=ตรวจหาการค้นพบ
機器検知 Client設定失敗=ตรวจหาความล้มเหลวในการตั้งค่าไคลเอ็นต์
機器検知 セキュリティ設定変更=ตรวจหาการเปลี่ยนแปลงการตั้งค่าความปลอดภัย
機器検知 死活監視=ตรวจหาการตรวจสอบสถานะการทำงาน
メーター登録依頼=คำขอลงทะเบียนมิเตอร์ของลูกค้า
レポート=รายงาน
未対応=อยู่ในคิว
レポート編集中=แก้ไขรายงาน
レポート編集済=การแก้ไขรายงานเสร็จสมบูรณ์
クローズ=ปิด
デバイス=อุปกรณ์
監視クライアント=ไคลเอ็นต์การตรวจสอบ
プリント管理サービス=บริการการจัดการการพิมพ์
EP通信集約サーバー=Secured Device Tool
その他問合せ=การสอบถามอื่นๆ
故障=ความล้มเหลว
消耗品=วัสดุสิ้นเปลือง
追加=เพิ่ม
移動=ย้าย
変更=เปลี่ยน
撤去=ทิ้ง
キーオペレーター=ผู้ดำเนินการหลักของลูกค้า
ヘルプデスク=แผนกให้ความช่วยเหลือ
ベンダー=ผู้ขาย
会社名=บริษัท
資産管理番号=หมายเลขสินทรัพย์ของผู้ใช้
他社機出力=ปริมาณจากอุปกรณ์มัลติฟังก์ชันอื่น
無=อัปเกรดแล้ว
有=สามารถอัปเกรดได้
情報無し=ไม่มีข้อมูล
制御SWバージョン情報=ข้อมูลเวอร์ชันซอฟต์แวร์การควบคุม
更新の必要性の有無=จำเป็นต้องอัปเดต
集計項目=รายการบทสรุป
セキュリティ対応状況\n※セキュリティ設定値\nに規定期間を超えた\n違反のあった件数=สถานะการสนับสนุนด้านความปลอดภัย\n* จำนวนการละเมิดการตั้งค่าความปลอดภัยที่เกินระยะเวลาที่กำหนด
弊社機=อุปกรณ์\nFUJIFILM\nBI
環境レポート=รายงานความยั่งยืนด้านสิ่งแวดล้อม
環境レポート-削減効果実績=ความยั่งยืนด้านสิ่งแวดล้อม - บทสรุป
月間消費電力量=การใช้พลังงานของอุปกรณ์
紙の削減による環境指標=การวัดความยั่งยืนด้านสิ่งแวดล้อมจากการลดการใช้กระดาษ
消費電力量削減=การลดการใช้พลังงาน
紙の削減=ประหยัดค่าใช้จ่ายจากการลดการใช้กระดาษ
CO2抑制量=หลีกเลี่ยง CO2
モード別電力時間／消費電力量=การใช้พลังงาน
消費電力使用比率=อัตราส่วนการใช้พลังงาน
消費電力量削減効果（KWh）=การลดการใช้พลังงาน (kWh)
紙の削減効果（USD）=ประหยัดค่าใช้จ่ายจากการลดการใช้กระดาษ (USD)
CO2抑制効果（kg-CO2）=หลีกเลี่ยง CO2 (kg-CO2)
常緑樹換算（本）=รักษาต้นไม้ไว้ได้ (ต้น)
推定消費電力量=ประมาณการยอด\nการใช้พลังงาน
実消費電力量=การใช้พลังงาน\nจริง
実消費電力=การใช้พลังงาน\nจริง
削減電力量=การใช้\nพลังงาน\nลดลง
推定使用枚数=ประมาณการยอด\nการใช้กระดาษ
実使用枚数=การใช้\nกระดาษที่คำนวณ\nได้จริง
削減枚数=การใช้\nที่คำนวณ\nได้จริง
推定CO2排出量=ประมาณการยอด\nการปล่อย CO2
実CO2排出量=การปล่อย CO2\nจริง
CO2排出量=การปล่อย CO2\nจริง
常緑樹本数=จำนวนต้นไม้ที่เขียวชอุ่มตลอดปี
環境レポート-各項目の説明と計算式 1=รายงานความยั่งยืนด้านสิ่งแวดล้อม - การคำนวณ 1
出力消費電力=การใช้พลังงานสำหรับ IOT
モード=โหมด
消費電力量（kWh）=การใช้พลังงาน
稼働モード（出力）=พิมพ์
待機モード=สแตนด์บาย
低電力モード=พลังงานต่ำ
スリープモード=พัก
電源オフモード=ปิดเครื่อง
小計=ผลรวมย่อย
入力消費電力=การใช้พลังงานสำหรับ IIT
稼働モード（入力）=IIT
IOT：イメージ出力端末(待ち。。。)=IOT: เทอร์มินัลเอาท์พุทภาพ - ทำงานขณะพิมพ์, ทำสำเนา (เอาท์พุท) หรือ แฟกซ์
IIT：イメージ入力端末（スキャンまたはコピー中に選択する）=IIT: เทอร์มินัลอินพุทภาพ - ทำงานขณะสแกนหรือทำสำเนา (อินพุท)
時間=ชั่วโมง
消費\n電力量=\u3000 การใช้\nพลังงาน
常緑樹換算\n（本）=อุปกรณ์มัลติฟังก์ชันของ FUJIFILM BI ช่วยประหยัดการใช้พลังงานได้อย่างมากในระหว่างโหมดพัก
消費電力をCO2吸収量に置き換えると=การปล่อย CO2 เทียบเท่ากับ
本分のCO2吸収量に相当=การดูดซับ\u2019 โดยต้นไม้ที่เขียวชอุ่มตลอดปี
常緑樹（杉）は樹齢50年、高さ20~30m=รักษาต้นไม้ไว้ได้
紙の削減による消費電力量削減計算=คำนวณการวัดความยั่งยืนด้านสิ่งแวดล้อมจากการลดการใช้กระดาษ
項目名=ชื่อรายการ
CO2抑制=หลีกเลี่ยง CO2
両面印刷またはNアップ印刷により削減した電力量を計算しています。=คำนวณปริมาณพลังงานที่ลดลงจากการพิมพ์ 2 ด้าน หรือ การพิมพ์หลายหน้าในหน้าเดียว (N-up)
両面印刷またはNアップ印刷により削減した出力枚数をUSDに換算しています。=แปลงจำนวนแผ่นเอาท์พุทที่ลดลงจากการพิมพ์ 2 ด้าน หรือ การพิมพ์หลายหน้าในหน้าเดียว (N-up) เป็น USD
消費電力量削減と紙の削減からCO2抑制量を計算しています。=คำนวณอัตราการลด CO2 จากการลดปริมาณการใช้พลังงานและการใช้กระดาษ
CO2抑制量を1年間の木の吸収量に置き換えて計算しています。=แสดงการลด CO2 ในมุมมองของต้นไม้ โดยดูตามปริมาณที่ต้นไม้ 1 ต้นดูดซับได้ในระยะเวลาหนึ่งปี
■削減電力量=\u25A0 การใช้พลังงานลดลง
削減枚数 * TEC / (PPMの二乗 * 2.5)=จำนวนแผ่นที่ลดลง  x  TEC / (PPM \u00B2 x  2.5)
■実消費電力量=\u25A0 การใช้พลังงานจริง
実使用枚数 * TEC / (PPMの二乗 * 2.5) =จำนวนแผ่นที่ใช้จริง  x  TEC / (PPM \u00B2 x  2.5)
■削減枚数 =\u25A0 จำนวนแผ่นที่ลดลง
削減枚数 * 1枚当たりの紙の単価 =จำนวนแผ่นที่ลดลง  x  ราคากระดาษต่อแผ่น
■実使用枚数=\u25A0 จำนวนแผ่นที่ใช้จริง
実使用枚数 * 1枚当たりの紙の単価 =จำนวนแผ่นที่ใช้จริง  x  ราคากระดาษต่อแผ่น
■CO2抑制量=\u25A0 หลีกเลี่ยง CO2
削減枚数 * 一枚あたりのCO2排出量 + 削減電力量 * 電力当たりのCO2排出量=จำนวนแผ่นที่ลดลง  x  การปล่อย CO2 ต่อแผ่น  +  การใช้พลังงานที่ลดลง  x  การปล่อย CO2 ต่อหน่วยพลังงาน
■CO2排出量=\u25A0 การปล่อย CO2
実使用枚数 * 一枚あたりのCO2排出量 + 実消費電力量 * 電力当たりのCO2排出量=จำนวนแผ่นที่ใช้จริง  x  การปล่อย CO2 ต่อแผ่น  +  การใช้พลังงานจริง  x  การปล่อย CO2 ต่อหน่วยพลังงาน
■常緑樹本数=\u25A0 จำนวนต้นไม้ที่เขียวชอุ่มตลอดปี
(削減枚数 * 一枚あたりのCO2排出量 + 削減電力量 * 電力当たりのCO2排出量) * 12 / 木の年間吸収量=(จำนวนแผ่นที่ลดลง  x  การปล่อย CO2 ต่อแผ่น  +  การใช้พลังงานที่ลดลง  x  การปล่อย CO2 ต่อหน่วยพลังงาน)  x  12 / CO2 ที่ดูดซับโดยต้นไม้ 1 ต้นในระยะเวลาหนึ่งปี
TEC　=　機種ごとの標準消費電力量（kWh）=TEC = การใช้พลังงานมาตรฐานสำหรับเครื่องแต่ละรุ่น (kWh)
PPM　=　機種ごとの１分当たりの印刷速度(枚/分)=PPM = ความเร็วในการพิมพ์ต่อนาทีสำหรับเครื่องแต่ละรุ่น (แผ่น/นาที)
一枚あたりのCO2排出量　=　0.005(kg-CO2/枚)=การปล่อย CO2 ต่อแผ่น = 0.005 (kg-CO2/แผ่น)
電力当たりのCO2排出量　=　 0.554(kg-CO2/kWh)=การปล่อย CO2 ต่อหน่วยพลังงาน = 0.554 (kg-CO2/kWh)
木の年間CO2吸収量　=　 14(kg-CO2/本)=CO2 ที่ดูดซับโดยต้นไม้ 1 ต้นในระยะเวลาหนึ่งปี = 14 (kg-CO2/ต้น)
1枚当たりの紙の単価 = 0.005(USD/枚)=ราคากระดาษต่อแผ่น = 0.005 (USD/แผ่น)
削減枚数 = Nアップ面数 + 両面印刷枚数=จำนวนแผ่นที่ลดลง = จำนวนภาพการพิมพ์หลายหน้าในหน้าเดียว (N-up)** + จำนวนแผ่นที่พิมพ์แบบ 2 ด้าน
実使用枚数 =片面印刷枚数 + 両面印刷枚数=จำนวนแผ่นที่ใช้จริง = จำนวนแผ่นที่พิมพ์แบบ 1 ด้าน + จำนวนแผ่นที่พิมพ์แบบ 2 ด้าน
※原稿はすべて偶数枚数、Nアップはすべて2アップと仮定して計算しています。 = การคำนวณจะเป็นการปัดเศษลงหลังจุดทศนิยม
※小数点以降は切り捨てで計算しています。= การคำนวณจะเป็นไปตามสมมติฐานที่ว่า ต้นฉบับทั้งหมดมีจำนวนแผ่นที่เท่ากัน และ การพิมพ์หลายหน้าในหน้าเดียว (N-up) ทั้งหมดเป็นแบบ 2 หน้า
消費電力量計算=คำนวณการวัดความยั่งยืนด้านสิ่งแวดล้อมจากการใช้พลังงานของอุปกรณ์
消費電力量=การใช้พลังงานของอุปกรณ์
常緑樹換算=รักษาต้นไม้ไว้ได้
説明=คำอธิบาย
各モードの経過時間から消費電力量を算出する。=การใช้พลังงานจะถูกคำนวณจากเวลาที่ใช้ไปของแต่ละโหมด
1年間の木の吸収量に基づくCO2排出量を算出する。=แสดงการปล่อย CO2 ในมุมมองของต้นไม้ โดยดูตามปริมาณที่ต้นไม้ 1 ต้นดูดซับได้ในระยะเวลาหนึ่งปี
本=ต้น
出力装置=เทอร์มินัลเอาท์พุทภาพ
入力装置=เทอร์มินัลอินพุทภาพ
稼働=พิมพ์
ウォームアップ=อุ่นเครื่อง
待機=สแตนด์บาย
低電力=พลังงานต่ำ
スリープ=พัก
電源オフ=ปิดเครื่อง
説明 \n(モード)=คำอธิบาย  (โหมด)
出力装置が稼働している状態=เทอร์มินัลเอาท์พุทกำลังทำงาน
出力機器のウォームアップ状態=เทอร์มินัลเอาท์พุทอยู่ในโหมดอุ่นเครื่อง
印刷ジョブを実行していない状態=งานพิมพ์ไม่ทำงาน
操作パネルや定着部の電力を下げている状態=แผงควบคุมและชุดทำความร้อนอยู่ในโหมดพลังงานต่ำ
ハードディスクなどへの電力供給を停止している状態=แหล่งจ่ายไฟไปยังฮาร์ดดิสก์ และอื่นๆ ถูกหยุดชั่วคราว
主電源がオフの状態=สวิตช์ไฟหลักถูกปิด
入力装置が稼働している状態=เทอร์มินัลอินพุทกำลังทำงาน
計算式=สูตร
(稼働モード(出力)時間/60)×稼動モード（出力）電力係数/1000=(เวลาของโหมดพิมพ์ในหน่วยนาที/60) x การใช้พลังงานในการพิมพ์/1000
ウォームアップ時間/60)×ウォームアップ電力係数/1000=(เวลาของโหมดอุ่นเครื่องในหน่วยนาที/60) x การใช้พลังงานในโหมดอุ่นเครื่อง/1000
(待機モード時間/60)×待機モード電力係数/1000=(เวลาของโหมดสแตนด์บายในหน่วยนาที/60) x การใช้พลังงานในโหมดสแตนด์บาย/1000
(低電力モード時間/60)×低電力モード電力係数/1000=(เวลาของโหมดพลังงานต่ำในหน่วยนาที/60) x การใช้พลังงานในโหมดพลังงานต่ำ/1000
(スリープモード時間/60)×スリープモード電力係数/1000=(เวลาของโหมดพักในหน่วยนาที/60) x การใช้พลังงานในโหมดพัก/1000
(電源オフモード時間/60)×電源オフモード電力係数/1000=(เวลาของโหมดปิดเครื่อง/60) x ค่าสัมประสิทธิ์กำลังของโหมดปิดเครื่อง/1000
(稼働モード(入力)時間/60)×稼働モード(入力)電力係数/1000=(เวลาของโหมดการดำเนินการในหน่วยนาที/60) x การใช้พลังงานในโหมดการดำเนินการ/1000
(消費電力量  x 1台当たりのCO2排出量) x 12 / 1年間の木の吸収量=(การใช้พลังงานของอุปกรณ์  x  การปล่อย CO2 ต่อหน่วยพลังงาน)  x  12 / CO2 ที่ดูดซับโดยต้นไม้ 1 ต้นในระยะเวลาหนึ่งปี
出力装置 = 印刷、コピーおよびファックスの消費電力量 (kWh)=เทอร์มินัลเอาท์พุทภาพ = การใช้พลังงานสำหรับการใช้งานเครื่องในระหว่างการพิมพ์, ทำสำเนา (เอาท์พุท) หรือ แฟกซ์ (kWh)
入力装置 = スキャンとコピーの消費電力量 (kWh)=เทอร์มินัลอินพุทภาพ = การใช้พลังงานสำหรับการใช้งานเครื่องในระหว่างการสแกน หรือ ทำสำเนา (อินพุท) (kWh)
電力係数 = 機種ごとに定めている電力係数 (W)=การใช้พลังงาน = อัตราการใช้พลังงานสำหรับโหมดการดำเนินการของเครื่องแต่ละรุ่น (W)
1台当たりのCO2排出量 = 0.554 (kg-CO2/kWh)=การปล่อย CO2 ต่อหน่วยพลังงาน = 0.554 (kg-CO2/kWh)
木の年間CO2吸収量 = 14 (kg-CO2/tree)=CO2 ที่ดูดซับโดยต้นไม้ 1 ต้นในระยะเวลาหนึ่งปี = 14 (kg-CO2/ต้น)
台数=อุปกรณ์
備考=หมายเหตุ
総台数=รวม
N-up/両面/機能別/紙の種類別の集計可能な台数=รองรับ N-up, 2 ด้าน, การใช้งาน, คุณสมบัติ, ชนิดกระดาษ
セキュリティオプションの管理対象台数=การสนับสนุนด้านความปลอดภัย
弊社機：○ の項目=u201Cอุปกรณ์ FUJIFILM BI\u201D: O
弊社機：○※1 の項目=u201Cอุปกรณ์ FUJIFILM BI\u201D: O
弊社機：○※2 の項目=u201Cอุปกรณ์ FUJIFILM BI\u201D: O
他社機：○ の項目=u201Cอุปกรณ์ของบริษัทอื่น\u201D: O
集計の前提条件（報告項目の母数）=พารามิเตอร์ประชากร
リージョン別サマリー=ดัชนีชี้วัดการบริการตามภูมิภาค
項番=หมายเลขผลิตภัณฑ์
目標値=เป้าหมาย
出力機器全台数=จำนวนอุปกรณ์
モノクロ機=อุปกรณ์ขาว-ดำ
カラー機=อุปกรณ์สี
カラー機割合=อัตราส่วนการใช้สี
サービスレベル*=ระดับการบริการ
可用率=ความพร้อมใช้งาน
故障のプロアクティブ対応率=อัตราส่วนเชิงรุกสำหรับข้อผิดพลาด
消耗品のプロアクティブ対応率=อัตราส่วนเชิงรุกสำหรับวัสดุสิ้นเปลือง
その他問い合わせ=จำนวนการสอบถามอื่นๆ
カラー=สี
カラー面数割合=อัตราส่วนการใช้สี
コスト=ค่าใช้จ่ายการพิมพ์ MPS
消費電力量削減(kWh)=การลดการใช้พลังงาน (kWh)
紙の削減(USD)=ประหยัดค่าใช้จ่ายจากการลดการใช้กระดาษ (USD)
CO2抑制量(kg-CO2)=หลีกเลี่ยง CO2 (kg-CO2)
常緑樹換算(Trees)=รักษาต้นไม้ไว้ได้ (ต้น)
CO2消費量(kg-CO2)=การปล่อย CO2 (kg)
* サービスレベルより良いスコアは=บรรลุ/เกินคะแนนเป้าหมาย SLA คือ
、サービスレベルより悪いスコアは=ต่ำกว่าคะแนนเป้าหมาย SLA คือ
の表記=.
過去12ヶ月のリージョンサマリー=ดัชนีชี้วัดการบริการ - 12 เดิอนที่ผ่านมา
出力機器=อุปกรณ์เอาท์พุท
認証方式の設定=ประเภทการรับรองความถูกต้อง
認証しない=ปิด
本体認証=เฉพาะที่
外部認証=ระยะไกล
カスタム認証=กำหนดเอง
集計管理機能の運用=ประเภทการทำบัญชี
運用しない=การทำบัญชีถูกปิดใช้งาน
本体集計管理=การทำบัญชีเฉพาะที่
ネット集計管理=การทำบัญชีเครือข่าย
認証サーバー=เซิร์ฟเวอร์การรับรองความถูกต้อง
デバイスへのアクセス(ServiceFeature)=การเข้าใช้งานอุปกรณ์ (คุณสมบัติการบริการ)
制限しない=ปลดล็อก
制限する=ล็อก
デバイスへのアクセス(JobStatus)=การเข้าใช้งานอุปกรณ์ (สถานะงาน)
デバイスへのアクセス(DeviceStatus)=การเข้าใช้งานอุปกรณ์ (สถานะอุปกรณ์)
制限する(表示)=ล็อก (แสดงไอคอน)
制限する(非表示)=ล็อก (ซ่อนไอคอน)
ファクス=แฟกซ์
インターネットファクス=อินเตอร์เน็ตแฟกซ์
メール送信=อีเมล
ボックス保存=สแกนไปยังโฟลเดอร์
ジョブメモリー=โปรแกรมที่ใช้งานบ่อย
PC保存=สแกน (PC)
プリンター=เครื่องพิมพ์
文書プリント=พิมพ์จาก USB
デジカメプリント=การพิมพ์รูปภาพ
ボックス操作=ส่งจากโฟลเดอร์
ジョブフロー=Job Flow Sheets
外部アクセス=เว็บแอปพลิเคชัน
BMLinkS=BMLinkS
URL送信=สแกน (URL)
USBメモリー保存=สแกนไปยัง USB
WSDスキャン=สแกนไปยังเดสก์ท็อป
ClientScan=ไคลเอ็นต์สแกน
カラーコピーの使用=การทำสำเนาสี
失敗回数=จำนวนครั้งที่ล้มเหลว
ゲストの使用=ผู้ใช้ที่เป็นแขก
しない=ปิด
する=เปิด
ICカードの使用=ใช้การ์ด IC
する(PKIのみ)=เปิด (PKI เท่านั้น)
認証システム設定=การตั้งค่าระบบการรับรองความถูกต้อง
ボックスからの外部取り出し=เรียกข้อมูลไฟล์จากโฟลเดอร์
一般ユーザーの認証失敗アクセス拒否=จำกัดจำนวนครั้งสูงสุดในการพยายามเข้าสู่ระบบของผู้ใช้เฉพาะที่
ユーザーIDを含むパスワード=รหัสผ่านประกอบด้วย ID ผู้ใช้
許可=อนุญาต
禁止=ไม่อนุญาต
パスワードの必須文字=อักขระที่จำเป็นต้องระบุในรหัสผ่าน
なし=ไม่มี
数字=หมายเลข
記号=สัญลักษณ์
数字と記号=หมายเลขและสัญลักษณ์
パスワード使用-ICカード認証時=รหัสผ่านสำหรับการเข้าสู่ระบบด้วยการ์ด IC
カストマーエンジニアの操作制限=ข้อจำกัดการใช้งานของตัวแทนให้บริการ
連続失敗回数=จำนวนครั้งสูงสุดที่ล้มเหลว
LDP-ポート=LDP - พอร์ต
停止=ปิดใช้งาน
起動=เปิดใช้งาน
LDP-ポート番号=LDP - หมายเลขพอร์ต
SMBクライアント-ポート=ไคลเอ็นต์ SMB - พอร์ต
IPP-ポート=IPP - พอร์ต
IPP-追加ポート番号(IPP)=IPP - หมายเลขพอร์ตที่เพิ่ม (IPP)
追加ポート番号(IPPS)=หมายเลขพอร์ตที่เพิ่ม (IPPS)
Bonjour-ポート=Bonjour - พอร์ต
Port9100-ポート=Port 9100 - พอร์ต
Port9100-ポート番号=Port 9100 - หมายเลขพอร์ต
SNMP-ポート=SNMP - พอร์ต
SIP-ポート=SIP - พอร์ต
SIP-ポート番号=SIP - หมายเลขพอร์ต
メール受信-ポート=รับอีเมล - พอร์ต
メール送信-ポート=ส่งอีเมล - พอร์ต
メール通知サービス-ポート=บริการแจ้งเตือนทางอีเมล - พอร์ต
UPnPディスカバリー-ポート=UPnP Discovery - พอร์ต
UPnPディスカバリー-ポート番号=UPnP Discovery - หมายเลขพอร์ต
WSDプリント-ポート=พิมพ์จากเดสก์ท็อป - พอร์ต
WSDスキャン-ポート=สแกนไปยังเดสก์ท็อป - พอร์ต
WSD-ポート番号=WSD - หมายเลขพอร์ต
BMLinkS-ポート=BMLinkS - พอร์ต
プリントサービス-ポート番号=บริการพิมพ์ - หมายเลขพอร์ต
ディスカバリー-ポート番号=Discovery - หมายเลขพอร์ต
インターネットサービス-ポート=Internet Services - พอร์ต
インターネットサービス-ポート番号=Internet Services - หมายเลขพอร์ต
WebDAV-ポート=WebDAV - พอร์ต
WebDAV-ポート番号=WebDAV - หมายเลขพอร์ต
ThinPrint-ポート=ThinPrint - พอร์ต
ThinPrint-ポート番号=ThinPrint - หมายเลขพอร์ต
開封確認(MDN)要求への応答=ตอบสนองต่อคำขอการตอบรับการอ่าน
開封確認(MDN)機能の使用=แสดงการตอบรับการอ่าน
送達確認メールの自動プリント=พิมพ์อีเมลยืนยันการส่ง
不達時のみプリントする=พิมพ์เมื่อการส่งไม่สมบูรณ์
動作周波数帯=ย่านความถี่ที่ใช้ดำเนินการ
自動=อัตโนมัติ
暗号化設定=การตั้งค่าการเข้ารหัส
暗号化なし=ไม่มีการเข้ารหัส
認証方式=วิธีการรับรองความถูกต้อง
Wi-FiDirect設定=การตั้งค่า Wi-Fi Direct
無効=ปิดใช้งาน
有効=เปิดใช้งาน
[LAN1]プロキシサーバーの使用=[LAN 1] ใช้พร็อกซีเซิร์ฟเวอร์
[LAN1]プロキシサーバー指定方法=[LAN 1] การตั้งค่าพร็อกซีเซิร์ฟเวอร์
手動で設定=การตั้งค่าด้วยตนเอง
PACファイルを指定=ใช้สคริปต์การกำหนดค่าพร็อกซีอัตโนมัติ
自動検出=การตั้งค่าการตรวจหาโดยอัตโนมัติ
[LAN1]PACファイルのURL=[LAN 1] ป้อน URL ไปยังสคริปต์การกำหนดค่า
[LAN1]HTTPプロキシサーバーサーバー名=[LAN 1] ชื่อพร็อกซีเซิร์ฟเวอร์ HTTP
[LAN1]プロキシを使用しないアドレス=[LAN 1] ที่อยู่ที่จะบายพาสพร็อกซีเซิร์ฟเวอร์
[LAN2]プロキシサーバーの使用=[LAN 2] ใช้พร็อกซีเซิร์ฟเวอร์
[LAN2]プロキシサーバー指定方法=[LAN 2] การตั้งค่าพร็อกซีเซิร์ฟเวอร์
[LAN2]PACファイルのURL=[LAN 2] ป้อน URL ไปยังสคริปต์การกำหนดค่า
[LAN2]HTTPプロキシサーバーサーバー名=[LAN 2] ชื่อพร็อกซีเซิร์ฟเวอร์ HTTP
[LAN2]プロキシを使用しないアドレス=[LAN 2] ที่อยู่ที่จะบายพาสพร็อกซีเซิร์ฟเวอร์
[Wi-Fi]プロキシサーバーの使用=[Wi-Fi] ใช้พร็อกซีเซิร์ฟเวอร์
[Wi-Fi]プロキシサーバー指定方法=[Wi-Fi] การตั้งค่าพร็อกซีเซิร์ฟเวอร์
[Wi-Fi]PACファイルのURL=[Wi-Fi] ป้อน URL ไปยังสคริปต์การกำหนดค่า
[Wi-Fi]HTTPプロキシサーバーサーバー名=[Wi-Fi] ชื่อพร็อกซีเซิร์ฟเวอร์ HTTP
[Wi-Fi]プロキシを使用しないアドレス=[Wi-Fi] ที่อยู่ที่จะบายพาสพร็อกซีเซิร์ฟเวอร์
HTTP-SSL/TLS通信=HTTP - การสื่อสาร SSL/TLS
HTTPSのみ使用可能=เปิดใช้งาน HTTPS เท่านั้น
HTTP/HTTPS使用可能=เปิดใช้งาน HTTP/HTTPS
LDAP-SSL/TLS通信=LDAP - การสื่อสาร SSL/TLS
S/MIME通信=การสื่อสาร S/MIME
SMTP-SSL/TLS通信=SMTP - การสื่อสาร SSL/TLS
SSL/TLS接続=SSL/TLS
STARTTLS接続=STARTTLS
STARTTLS接続(利用可能時)=STARTTLS (ถ้ามี)
POP3-SSL/TLS通信=POP3 - การสื่อสาร SSL/TLS
SSL証明書検証失敗時の動作=การตรวจสอบใบรับรอง SSL ล้มเหลว
アクセスを中止する=หยุดการเข้าใช้เว็บ
アクセスを確認する=เตือนผู้ใช้ก่อนเข้าใช้งาน
IPsec通信=การสื่อสาร IPsec
証明書検証レベル=ระดับการตรวจสอบใบรับรอง
低=ต่ำ
中=กลาง
高=สูง
メッセージダイジェスト方式=อัลกอริทึมการแยกย่อยข้อความ
本文の暗号化方式=อัลกอริทึมการเข้ารหัสข้อความ
データの暗号化=การเข้ารหัสข้อความ
ストレージの上書き消去設定=เขียนทับที่จัดเก็บข้อมูล
上書き回数の設定=จำนวนการเขียนทับ
1回=เขียนทับ 1 ครั้ง
3回=เขียนทับ 3 ครั้ง
機械起動時のプログラム診断=ระบบทดสอบตนเองเมื่อเปิดเครื่อง
稼働時の改ざん防止=การปกป้องบูรณภาพขณะทำงาน
ログ記録のみ=เปิด (บันทึกเท่านั้น)
マイフォルダー保存=โฟลเดอร์ของฉัน
隠し文字印刷初期値=เอฟเฟกต์ลายน้ำเริ่มต้น
浮き出し=พื้นผิวพิเศษ
白抜き=แบบมีเส้นขอบ
しない（スタンプ印刷）=ปิด
イメージログ管理=การควบคุมไฟล์เก็บภาพ
宛先の再入力=ป้อนผู้รับใหม่อีกครั้ง
複数宛先時のみする(デフォルト)=ยืนยันอีกครั้งถ้าผู้รับหลายคน (ค่าเริ่มต้น)
イメージログ作成対象-ファクス=เป้าหมายไฟล์เก็บภาพ - แฟกซ์
制限方法=การกรองโดเมน
送受信許可ドメインの指定=อนุญาตโดเมน
送受信拒否ドメインの指定=บล็อกโดเมน
受信メールシートのプリント=ตัวเลือกการพิมพ์อีเมลขาเข้า
ヘッダーのすべてと本文をプリント=ไฟล์แนบ หัวกระดาษแบบเต็ม และข้อความ
ヘッダーの一部と本文をプリント（本文がなければプリントしないOFF）=ไฟล์แนบ หัวกระดาษแบบพื้นฐาน และข้อความ (อย่าพิมพ์ถ้าไม่มีข้อความ - ปิด)
ヘッダーの一部と本文をプリント（本文がなければプリントしないON）=ไฟล์แนบ หัวกระดาษแบบพื้นฐาน และข้อความ (อย่าพิมพ์ถ้าไม่มีข้อความ - เปิด)
エラー通知メールの自動プリント=การพิมพ์อีเมลแจ้งเตือนข้อผิดพลาดโดยอัตโนมัติ
受信時のPJL命令制御=การควบคุมคำสั่งรับ PJL
出力時のPJL命令制御=การควบคุมคำสั่งเอาท์พุท PJL
認証成功のジョブ=การเข้าสู่ระบบงานสำเร็จ
プライベートプリントに保存=บันทึกเป็นงานไพรเวทชาร์จพรินต์
認証が不正のジョブ=การเข้าสู่ระบบงานล้มเหลว
中止=ยกเลิก
認証プリントに保存=บันทึกเป็นงานชาร์จพรินต์
UserIDなしのジョブ(プリント)=งานที่ไม่มี ID ผู้ใช้ (พิมพ์งาน)
認証プリントに保存/ジョブを中止=บันทึกเป็นงานชาร์จพรินต์ / ลบงาน
UserIDなしのジョブ(ジョブの保存)=งานที่ไม่มี ID ผู้ใช้ (บันทึกงาน)
ジョブを中止=ลบงาน
PJL命令なしのジョブ=งานที่ไม่ใช้คำสั่ง PJL
認証・セキュリ認証プリントに保存=บันทึกเป็นงานชาร์จพรินต์ หรือ งานพิมพ์แบบปลอดภัย
プリントジョブを強制蓄積する=บังคับจัดเก็บงานพิมพ์
PDF署名=PDF Signature
常に署名しない=ไม่ใส่ลายเซ็น
常に可視署名する=ใส่ลายเซ็นที่มองเห็นได้ทุกครั้ง
常に不可視署名する=ใส่ลายเซ็นที่มองไม่เห็นทุกครั้ง
送信時に選択する=เลือกเมื่อส่ง
DocuWorks署名=DocuWorks Signature
常に署名する=ใส่ลายเซ็นทุกครั้ง
印字する日付の形式=รูปแบบวันที่
20yy年mm月dd日=YYYYMMDD
実行完了ジョブの表示設定=การขอดูงานที่เสร็จสมบูรณ์
常に表示する=อนุญาตให้ดูงานได้ทุกเวลา
認証中は表示する=ต้องเข้าสู่ระบบเพื่อขอดูงาน
表示しない=ซ่อน
両方=ทั้งสองรายการ
組み込みプラグイン機能=ปลั๊กอินแบบฝัง
UUID印字=พิมพ์ Universal Unique ID
IPv4-受付IPアドレス制限=IPv4 - ตัวกรอง IP
IPv6-受付IPアドレス制限=IPv6 - ตัวกรอง IP
監査ログの記録=เก็บบันทึกการตรวจสอบ
セキュリティ警告-機械管理者設定=คำเตือนเกี่ยวกับความปลอดภัย (ผู้ดูแล)
警告画面を表示しない=ไม่แสดงคำเตือน
警告画面を表示する=แสดงคำเตือน
セキュリティ警告-SNMP設定=คำเตือนเกี่ยวกับความปลอดภัย (SNMP)
セキュリティ警告-グローバルIPアドレス設定=คำเตือนเกี่ยวกับความปลอดภัย (IP ส่วนกลาง)
ファクス送信(PC送信)=ส่งแฟกซ์ (ส่งไปยัง PC)
ファクス送信(通常送信)=ส่งแฟกซ์ (ส่งปกติ)
ファクス受信(未出力)=รับแฟกซ์ (ไม่พิมพ์)
ファクス受信(受信出力)=รับแฟกซ์ (พิมพ์แฟกซ์)
撤去/移動日=วันที่ทิ้ง/ย้าย
プロアクティブ対応率=อัตราการตอบสนองเชิงรุก
故障インシデント対応者=ผู้ที่จัดการกับเหตุการณ์ข้อผิดพลาด
故障インシデント事象=เหตุการณ์ที่เกิดข้อผิดพลาด
インシデントのプロアクティブ対応率=อัตราการตอบสนองเชิงรุกสำหรับเหตุการณ์
対応区分=ประเภทการสนับสนุน
割合=การกระจายข้อมูล
関連情報=ข้อมูลที่เกี่ยวข้อง
関連サービス=บริการที่เกี่ยวข้อง
お知らせ登録=เพิ่มประกาศ
お知らせ=ประกาศ
お知らせはありません。=ไม่มีประกาศ
＞ お知らせ登録=> เพิ่มประกาศ
＞ 全て見る=> ดูทั้งหมด
台=อุปกรณ์
Guardiaクライアントを確認=ตรวจสอบไคลเอ็นต์ Guardia
動作停止中のGuardiaクライアント=ไคลเอ็นต์ Guardia ไม่ทำงาน
動作停止中のGuardiaクライアントがあります。=มีไคลเอ็นต์ Guardia อย่างน้อยหนึ่งรายการที่หยุดทำงาน
動作停止中のGuardiaクライアントはありません。=ไคลเอ็นต์ Guardia ทั้งหมดทำงานอยู่
機器を確認=ดูอุปกรณ์
通信停止中の機器=อุปกรณ์ไม่สื่อสาร
通信停止中の機器があります。=มีอุปกรณ์อย่างน้อยหนึ่งเครื่องที่หยุดการสื่อสาร
通信停止中の機器はありません。=อุปกรณ์ทั้งหมดกำลังสื่อสาร
メーター未取得の機器=อุปกรณ์ที่ไม่มีการอ่านค่ามิเตอร์
メーターを入力してください。=ป้อนข้อมูลการอ่านค่ามิเตอร์
メーターを確認=ส่งข้อมูลมิเตอร์
ユーザーガイド=คู่มือการใช้งาน
掲載開始日=วันที่เริ่ม
掲載終了日=วันที่สิ้นสุด
タイトル=ชื่อเรื่อง
公開/非公開=สาธารณะ/ส่วนตัว
公開=สาธารณะ
非公開=ส่วนตัว
新規作成=สร้างใหม่
内容=คำอธิบาย
お知らせ登録を完了しました。=เพิ่มประกาศแล้ว
出力機器=อุปกรณ์
Guardiaクライアント=ไคลเอ็นต์ Guardia
機器詳細=ข้อมูลอุปกรณ์
配置図=แบบแปลน
監視対象=การตรวจสอบ
基本情報=ข้อมูลพื้นฐาน
監視対象機器=อุปกรณ์ที่ตรวจสอบ
ドライバー=โปรแกรมควบคุม
マニュアル=คู่มือ
商品情報=ข้อมูลผลิตภัณฑ์
サポート情報=ข้อมูลการสนับสนุน
利用開始日=วันที่เริ่มใช้งาน
一次連絡先=ผู้ติดต่อหลัก
配置図は存在しません。=ไม่พบแบบแปลน
ドライバーは存在しません。=ไม่พบโปรแกรมควบคุม
マニュアルは存在しません。=ไม่พบคู่มือ
商品情報は存在しません。=ไม่พบข้อมูลผลิตภัณฑ์
サポート情報は存在しません。=ไม่พบข้อมูลการสนับสนุน
メーター=มิเตอร์
メーター一括ダウンロード=ดาวน์โหลดชุดมิเตอร์
報告期日=วันที่รายงาน
今回締切日=วันที่สิ้นสุดของรอบการเรียกเก็บเงิน
メーター値未入力の機器のみを表示=แสดงเฉพาะอุปกรณ์ที่ไม่มีการอ่านค่ามิเตอร์
今回/前回=ปัจจุบัน/ก่อนหน้า
メーター1=มิเตอร์ 1
メーター2=มิเตอร์ 2
メーター3=มิเตอร์ 3
メーター4=มิเตอร์ 4
メーター5=มิเตอร์ 5
今回カウント=จำนวนปัจจุบัน
前回カウント=จำนวนก่อนหน้า
入力=ป้อนข้อมูล
メーター1（今回カウント）=มิเตอร์ 1 (จำนวนปัจจุบัน)
メーター2（今回カウント）=มิเตอร์ 2 (จำนวนปัจจุบัน)
メーター3（今回カウント）=มิเตอร์ 3 (จำนวนปัจจุบัน)
メーター4（今回カウント）=มิเตอร์ 4 (จำนวนปัจจุบัน)
メーター5（今回カウント）=มิเตอร์ 5 (จำนวนปัจจุบัน)
メーター1（前回カウント）=มิเตอร์ 1 (จำนวนก่อนหน้า)
メーター2（前回カウント）=มิเตอร์ 2 (จำนวนก่อนหน้า)
メーター3（前回カウント）=มิเตอร์ 3 (จำนวนก่อนหน้า)
メーター4（前回カウント）=มิเตอร์ 4 (จำนวนก่อนหน้า)
メーター5（前回カウント）=มิเตอร์ 5 (จำนวนก่อนหน้า)
メーター1（合計面数またはページカウント）=มิเตอร์ 1 (รวมจำนวนภาพหรือจำนวนหน้าทั้งหมด)
メーター1（カラー面数）=มิเตอร์ 1 (จำนวนภาพสี)
メーター2（モノクロ面数）=มิเตอร์ 2 (จำนวนภาพขาว-ดำ)
メーター確認日=วันที่อ่านค่ามิเตอร์
メーター入力を受け付けました。=ระบบได้รับข้อมูลการอ่านค่ามิเตอร์แล้ว
未入力=ไม่ได้ป้อนข้อมูล
メーター推移確認=การตรวจสอบการเปลี่ยนมิเตอร์
トータルメーター=มิเตอร์ทั้งหมด
この内容で送信してもよろしいでしょうか？=ส่งเนื้อหานี้ได้หรือไม่
メーター入力項目から、1つ以上の項目を入力してください。=ป้อนข้อมูลอย่างน้อยหนึ่งรายการจากการอ่านค่ามิเตอร์
以下のメーター値について、今回カウントが前回カウントより小さい値ですが、この値でよろしいですか？\r\n=คำเตือน
出力面数=จำนวนภาพเอาท์พุท
モノクロ=ขาว-ดำ
カラー=สี
基準面数=จำนวนภาพอ้างอิง
モノクロ出力面数月度推移=การเปลี่ยนแปลงรายเดือน - จำนวนภาพเอาท์พุทขาว-ดำ
カラー出力面数 月度推移=การเปลี่ยนแปลงรายเดือน - จำนวนภาพเอาท์พุทสี
機能別利用状況=การใช้งานตามคุณสมบัติ
出力時の紙の種類=ชนิดกระดาษเอาท์พุท
レポート名=ชื่อรายงาน
更新日=อัปเดตเมื่อ
ファイルサイズ=ขนาดไฟล์
利用状況=การใช้งาน
{year}年1月～{year}年12月=มกราคม {year} ถึง ธันวาคม {year}
1月=มกราคม
2月=กุมภาพันธ์
3月=มีนาคม
4月=เมษายน
5月=พฤษภาคม
6月=มิถุนายน
7月=กรกฎาคม
8月=สิงหาคม
9月=กันยายน
10月=ตุลาคม
11月=พฤศจิกายน
12月=ธันวาคม
合計=รวม
単位:面=หน่วย
機能別利用状況 月度推移=การเปลี่ยนแปลงรายเดือน - การใช้งานตามคุณสมบัติ
コピー=ทำสำเนา
プリント=พิมพ์
スキャン=สแกน
ファクス受信=รับแฟกซ์
ファクス送信=ส่งแฟกซ์
ファクス送信(PC送信)=ส่งแฟกซ์ (ส่งไปยัง PC)
ファクス送信(通常送信)=ส่งแฟกซ์ (ส่งปกติ)
ファクス受信(未出力)=รับแฟกซ์ (ไม่พิมพ์)
ファクス受信(受信出力)=รับแฟกซ์ (พิมพ์แฟกซ์)
出力時の紙の種類　月度推移=ชนิดกระดาษเอาท์พุท
単位:枚=หน่วย
電源オフモード=โหมดปิดเครื่อง
スリープモード=โหมดพัก
ウォームアップ=อุ่นเครื่อง
待機モード=โหมดสแตนด์บาย
稼働モード=โหมดที่ใช้งานอยู่
低電力モード=โหมดพลังงานต่ำ
ダウンロード=ดาวน์โหลด
レポートは公開されていないのでダウンロードできません。=ไม่สามารถดาวน์โหลดรายงานได้เนื่องจากยังไม่ได้เผยแพร่ให้เป็นสาธารณะ
消耗品依頼=วัสดุสิ้นเปลือง
お届け先=รายละเอียดของผู้รับ
*お届け先に変更がある場合は、下記情報を変更してください。=* หากมีการเปลี่ยนแปลงรายละเอียดของผู้รับ โปรดอัปเดตข้อมูลด้านล่าง
依頼内容をご確認の上、「この内容で送信する」をクリックしてください。=หลังจากที่ได้ตรวจสอบรายละเอียดคำขอของคุณเรียบร้อยแล้ว ให้คลิก ส่ง
注文番号：=หมายเลขการสั่งซื้อ:
お届け希望日=วันที่จัดส่งที่ต้องการ
* 発注可能なのは1ヶ月先までです=คุณสามารถสั่งซื้อล่วงหน้าได้ถึง 1 เดือน
注文明細=รายละเอียดการสั่งซื้อ
商品名=ชื่อผลิตภัณฑ์
注文数量=จำนวน
トナーカートリッジ(K) 黒=ตลับผงหมึกสีดำ (K)
トナーカートリッジ(C) シアン=ตลับผงหมึกสีไซแอน (C)
トナーカートリッジ(M) マゼンダ=ตลับผงหมึกสีมาเจนต้า (M)
トナーカートリッジ(Y) イエロー=ตลับผงหมึกสีเหลือง (Y)
トナー回収ボトル=กล่องทิ้งเศษผงหมึก
使用済み消耗品の回収=การรวบรวมวัสดุสิ้นเปลืองที่ใช้แล้ว
* 下記商品は、ご契約内容によらず有償です。=* ต้องชำระเงินสำหรับผลิตภัณฑ์ต่อไปนี้ไม่ว่าคุณจะมีสัญญาแบบใดก็ตาม
ホチキス針=ลวดเย็บ
ホチキス針 中とじ用=ลวดเย็บ
スタンプ交換キット=ชุดเปลี่ยนทดแทนตราประทับ
消耗品依頼を受け付けました。=ระบบได้รับคำขอวัสดุสิ้นเปลืองของคุณแล้ว
MACD依頼を受け付けました。\r\n後日、弊社担当からご連絡いたします。=ระบบได้รับคำขอ MACD ของคุณแล้ว\r\nเราจะทำการติดต่อกลับในเร็วๆ นี้
出力機器 MACD 依頼書 の 添付 [必須] =แบบฟอร์ม MACD [จำเป็นต้องระบุ]
* マップ情報等を送付いただく場合は、ファイルをまとめて圧縮し、1ファイルにして添付してください。=* เมื่อมีการส่งไฟล์ เช่น ข้อมูลแผนที่ โปรดบีบอัดไฟล์ต่างๆ เข้าด้วยกันและแนบเป็นไฟล์เดียว
MACD依頼時は、以下のボタンから 出力機器 MACD依頼書 をダウンロードして記入してください。=หากต้องการส่งคำขอ MACD โปรดดาวน์โหลดแบบฟอร์ม MACD และแนบข้อมูลที่กรอกครบถ้วนแล้วที่ด้านล่าง
MACD種別=ชนิด MACD
移動=ย้าย
追加=เพิ่ม
変更=เปลี่ยน
撤去=ทิ้ง
故障修理依頼=ซ่อมแซม
故障修理依頼を受け付けました。\r\n後日、弊社担当からご連絡いたします。=ระบบได้รับคำขอซ่อมแซมของคุณแล้ว\r\nเราจะทำการติดต่อกลับในเร็วๆ นี้
希望日=วันที่ต้องการ
至急=ด่วน
本日中=ภายในวันนี้
明日中=ภายในวันพรุ่งนี้
エラーメッセージやエラーコードが表示=ข้อความข้อผิดพลาดและรหัสข้อผิดพลาดปรากฏขึ้น
操作パネルのランプが点灯=ไฟสัญญาณของแผงควบคุมสว่างขึ้น
コピー/プリント結果に問題がある=ปัญหาเกี่ยวกับผลการทำสำเนา/พิมพ์
原稿づまり=กระดาษติด
用紙づまり/出力された用紙の破損=กระดาษติด/เอาท์พุทเสียหาย
出力されない/出力時の不具合=เอาท์พุทผิดพลาด
機械本体のトラブル=ปัญหาอุปกรณ์
スキャン時のトラブル=ปัญหาขณะสแกน
ファクス時のトラブル=ปัญหาขณะแฟกซ์
交換メッセージ=ข้อความการเปลี่ยนทดแทน
ランプ点滅=ไฟสัญญาณกะพริบ
ランプ点灯=ไฟสัญญาณสว่างขึ้น
印字濃度が薄い=ความเข้มในการพิมพ์จางเกินไป
汚れる(点、線、筋)=หมึกเลอะ (จุด/เส้น/ริ้ว)
用紙全体が黒で出力される=เอาท์พุทออกมาเป็นสีดำทั้งหมด
擦るとトナーが指に着く=ผงหมึกหลุดร่อนออกจากกระดาษ
ずれる/曲がる/斜めに出力される=เอาท์พุทออกมาไม่ตรงแนว/โค้งงอ/เอียง
欠ける、正しく出力されない=เอาท์พุทขาดหายไปหรือไม่ถูกต้อง
色合い、色味の再現性が悪い=สีเพี้ยนหรือการพิมพ์สีที่ไม่ได้มาตรฐาน
原稿づまり、原稿送りに不具合=กระดาษติดหรือป้อนกระดาษผิดพลาด
本体内での紙づまり=กระดาษติดด้านในอุปกรณ์
用紙トレイでの紙づまり=กระดาษติดในถาด
フィニッシャーでの紙づまり=กระดาษติดในเครื่องจัดชุดเอกสาร
用紙づまり、紙しわがたびたび発生=กระดาษติดบ่อยและมีรอยยับ
プリントできない/コピーできない=ไม่สามารถพิมพ์/ทำสำเนาได้
ランプ点灯、点滅したまま=ไฟสัญญาณสว่างขึ้นหรือกะพริบตลอดเวลา
文字化け=ข้อความดูผิดเพี้ยน
希望のサイズにコピーされない=เอาท์พุทการทำสำเนาไม่ใช่ขนาดที่ฉันต้องการ
ホチキスがうまく留まらない=ลวดเย็บหลวม
電源入らず=เปิดสวิตช์เครื่องไม่ได้
コンセントに挿しているのに電源入らず=ไม่สามารถเปิดสวิตช์เครื่องได้แม้ว่าจะได้เสียบปลั๊กแล้ว
操作パネルのディスプレイ暗い=หน้าจอแผงควบคุมมืด
音について=เสียง
用紙トレイ関連の動作不良=ความผิดปกติที่เกี่ยวข้องกับถาดกระดาษ
部品損傷/交換部品=ชิ้นส่วนเสียหาย/อะไหล่ทดแทน
まとめて一枚機能=คุณสมบัติการพิมพ์หลายหน้าในหน้าเดียว
ネットワークスキャン=สแกนไปยังเครือข่าย
親展ボックス内のファイル削除=การลบไฟล์ในโฟลเดอร์
親展ボックスのパスワード=รหัสผ่านโฟลเดอร์
利用できない=ไม่สามารถใช้ได้
送信できず=ไม่สามารถส่งได้
受信できず=ไม่สามารถรับได้
送受信ともできず=ไม่สามารถรับ-ส่งได้
ドラムカートリッジ=ตลับลูกดรัม
ドラムカートリッジ(AorR)1=ตลับลูกดรัม (A หรือ R) 1
ドラムカートリッジ(AorR)2=ตลับลูกดรัม (A หรือ R) 2
ドラムカートリッジ(AorR)3=ตลับลูกดรัม (A หรือ R) 3
ドラムカートリッジ(AorR)4=ตลับลูกดรัม (A หรือ R) 4
定着=ชุดทำความร้อน
ベルト=สายพาน
機械本体の設定=การตั้งค่าอุปกรณ์
コピー機能の設定=การตั้งค่าการทำสำเนา
スキャン機能の設定=การตั้งค่าการสแกน
プリント機能の設定=การตั้งค่าการพิมพ์
ファックス機能の設定=การตั้งค่าแฟกซ์
ネットワーク機能の設定=การตั้งค่าเครือข่าย
機械本体の操作=การใช้งานอุปกรณ์
コピー機能=ทำสำเนา
スキャン機能=สแกน
プリント機能=พิมพ์
ファックス機能=แฟกซ์
ドライバー/ソフトウェアのインストールと設定=การติดตั้งและการตั้งค่าโปรแกรมควบคุม/ซอฟต์แวร์
操作方法=การใช้งาน
消耗品の仕様=ข้อมูลจำเพาะของวัสดุสิ้นเปลือง
消耗品の残量確認や交換方法=การตรวจสอบยอดคงเหลือและการเปลี่ยนวัสดุสิ้นเปลือง
用紙の補給方法=การใส่กระดาษ
本体を清掃する方法=การทำความสะอาดอุปกรณ์
本体を移動する方法=การเคลื่อนย้ายอุปกรณ์
レポート出力/メーター確認/機械番号の調べ方=รายงานการพิมพ์/ยอดรวมการใช้บริการ/ค้นหาหมายเลขอุปกรณ์
定期的な画質調整の実施=การปรับเทียบเป็นระยะๆ
操作問い合わせ=การสอบถามการใช้งาน
操作問い合わせを受け付けました。\r\n後日、弊社担当からご連絡いたします。=ระบบได้รับการสอบถามเกี่ยวกับการใช้งานของคุณแล้ว\r\nเราจะทำการติดต่อกลับในเร็วๆ นี้
富士フイルムビジネスイノベーションオンラインサポートを見る=โปรดดูการสนับสนุนแบบออนไลน์ของ ฟูจิฟิล์ม บิสซิเนส อินโนเวชั่น
その他問い合わせを受け付けました。\r\n後日、弊社担当からご連絡いたします。=ระบบได้รับการสอบถามจากคุณแล้ว\r\nเราจะทำการติดต่อกลับในเร็วๆ นี้
機械の設定方法（機械管理者向け）=การกำหนดค่าอุปกรณ์ (สำหรับผู้ดูแลระบบ)
機械本体での操作方法=การใช้งานบนอุปกรณ์
パソコンでの操作方法=การใช้งานบน PC
消耗品=วัสดุสิ้นเปลือง
日常管理=การบำรุงรักษารายวัน
MACD依頼=MACD
その他問い合わせ=การสอบถามอื่นๆ
問い合わせ内容=การสอบถาม
消耗品の依頼項目から、1つ以上の項目を選択（入力）してください。=เลือก (ป้อน) อย่างน้อยหนึ่งรายการจากรายการคำขอวัสดุสิ้นเปลือง
修理点検の依頼項目から、1つ以上の項目を選択（入力）してください。=เลือก (ป้อน) อย่างน้อยหนึ่งรายการไปยังคำขอตรวจสอบและซ่อมแซม
操作設定方法のお問い合わせ項目から、1つ以上の項目を選択（入力）してください。=เลือก (ป้อน) การสอบถามอย่างน้อยหนึ่งรายการในการตั้งค่าการใช้งาน
依頼履歴=ประวัติคำขอ
受付番号=หมายเลขการรับ
こちらのページでは保守の受付履歴がご確認いただけます。\r\n「受付番号」をクリックすると、受付内容を参照できます。=หน้านี้จะแสดงคำขอการบำรุงรักษาที่ได้รับครั้งก่อน\r\nคลิกที่ [หมายเลขการรับ] เพื่อดูรายละเอียดของคำขอ
受付内容=รายละเอียด
受付日時=วันที่ได้รับ
ステータス=สถานะ
区分=ประเภท
修理点検依頼=คำขอตรวจสอบและซ่อมแซม
メーター入力=การอ่านค่ามิเตอร์
MACD種別=ชนิด MACD
問合せ内容=การสอบถาม
利用規約=ข้อกำหนดการใช้งาน
プライバシーポリシー=นโยบายความเป็นส่วนตัว
利用上の注意=ข้อควรระวัง
富士フイルムビジネスイノベーションについて=เกี่ยวกับ ฟูจิฟิล์ม บิสซิเนส อินโนเวชั่น
Simplified Chinese/簡体字中国語=จีนประยุกต์
Traditional Chinese/繁体字中国語=จีนดั้งเดิม
English/英語=อังกฤษ
Japanese/日本語=ญี่ปุ่น
Korean/韓国語=เกาหลี
最初ページ=หน้าแรก
最終ページ=หน้าสุดท้าย
ログアウト=ออกจากระบบ
テナント切替=สลับโปรเจค
{label} [必須]=จำเป็นต้องระบุ
ラベル1=ป้ายฉลาก 1
検索対象=ค้นหา
上記条件で絞り込み=กรองตามเงื่อนไขข้างต้น
アセット番号=หมายเลขสินทรัพย์
機種=รุ่น
シリアル番号=หมายเลขผลิตภัณฑ์
事業所名=ออฟฟิศ
設置場所=ตำแหน่งที่ตั้ง
デバイスタイプ=ประเภทอุปกรณ์
状態=สถานะ
閉じる=ปิด
メーカー=ผู้ผลิต
住所=ที่อยู่
名前=ชื่อ
部門名=แผนก
メールアドレス=ที่อยู่อีเมล
電話番号=หมายเลขโทรศัพท์
ホスト名=ชื่อโฮสต์
IPアドレス=ที่อยู่ IP
全{ totalPage }件=รวม {totalPage}
稼働中=ทำงานอยู่
停止中=หยุด
不明=ไม่ทราบ
すべて=ทั้งหมด
設置前=ก่อนการติดตั้ง
サービス準備中=กำลังเตรียมการบริการ
停止中(90日以上)=หยุด (เกิน 90 วัน)
撤去/移動日=วันที่ทิ้ง/ย้าย
戻る=ย้อนกลับ
内容を修正する=แก้ไข
この内容で送信する=ส่ง
内容を確認する=ยืนยัน
会社名=บริษัท
入力内容が破棄されます。よろしいですか？=คุณแน่ใจหรือไม่ว่าต้องการจะล้างข้อมูลที่ป้อน
添付ファイルサイズが{ size }MBを超えています。=ขนาดไฟล์แนบเกิน {size} MB
選択されたファイルが正しくありません。ファイルを再度選択してください。=ไฟล์ที่เลือกนั้นไม่ถูกต้อง โปรดเลือกไฟล์อื่น
ファイルにアクセスする許可がありません。=คุณไม่มีสิทธิ์ในการเข้าใช้ไฟล์
* 添付ファイルサイズは5MBが上限です=*สูงสุด 5 MB
添付ファイルサイズは5MBが上限です=สูงสุด 5 MB
お知らせは公開されていないので閲覧できません。=ไม่สามารถดูประกาศได้เนื่องจากยังไม่ได้เผยแพร่ให้เป็นสาธารณะ
個=ชิ้น
その他=อื่นๆ
選択してください=โปรดเลือก
添付ファイル=ไฟล์แนบ
出力機器 MACD依頼書 ダウンロード =ดาวน์โหลดแบบฟอร์ม MACD
{ target }へ戻る=ย้อนกลับไปยัง {target}
{label}は必須項目です。=จำเป็นต้องระบุ {label}
{ max }以下の数値を入力してください。=ป้อนค่าตัวเลขไม่เกิน {max}
1以上の数値を入力してください。=ป้อนค่าตัวเลขที่ไม่ต่ำกว่า 1
{max}文字以内で入力してください。=ป้อนอักขระไม่เกิน {max} ตัว
メールアドレスのフォーマットが正しくありません。メールアドレスを正しく入力してください。=รูปแบบที่อยู่อีเมลไม่ถูกต้อง โปรดป้อนที่อยู่อีเมลที่ถูกต้อง
電話番号のフォーマットが正しくありません。電話番号を正しく入力してください。=รูปแบบหมายเลขโทรศัพท์ไม่ถูกต้อง โปรดป้อนหมายเลขโทรศัพท์ที่ถูกต้อง
入力内容=รายละเอียดที่ป้อน
連絡先=ผู้ติดต่อ
該当データがありません。=ไม่พบผลลัพธ์
システムエラーが発生しました。しばらく時間をおいてから再度お試しください。=เกิดข้อผิดพลาดของระบบ โปรดลองใหม่อีกครั้งในภายหลัง
内容入力後、「内容を確認する」をクリックしてください。\r\n内容確認のために、お電話をさしあげる場合がありますが、ご了承ください。=หลังจากที่ได้ป้อนรายละเอียดแล้ว ให้คลิก ยืนยัน\r\nเราอาจโทรหาคุณเพื่อตรวจสอบรายละเอียด
内容入力後、「内容を確認する」をクリックしてください。=หลังจากที่ได้ป้อนรายละเอียดแล้ว ให้คลิก ยืนยัน
入力内容をご確認の上、「この内容で送信する」をクリックしてください。=หลังจากที่ได้ตรวจสอบรายละเอียดที่ป้อนเข้าไปแล้ว ให้คลิก ส่ง
* ご連絡先に変更がある場合は、下記情報を変更してください。=* หากมีการเปลี่ยนแปลงรายละเอียดผู้ติดต่อของคุณ โปรดอัปเดตข้อมูลด้านล่าง
最終更新日=อัปเดตครั้งล่าสุดเมื่อ
備考=หมายเหตุ
依頼内容=รายละเอียดคำขอ
お問い合わせ内容=การสอบถาม
編集=แก้ไข
選択されたファイルタイプが正しくありません。正しいファイル形式は\".zip\"です。=ไฟล์ที่เลือกนั้นไม่ถูกต้อง ชนิดไฟล์ที่ถูกต้องจะต้องเป็น \".zip\"
ページにアクセスできません=ไม่สามารถเข้าใช้งานหน้าได้
ページが見つかりませんでした=ไม่พบหน้านี้
アクセス権限がありません。再ログインするか、画面をリフレッシュしてください。=คุณไม่มีสิทธิ์ในการเข้าใช้งาน โปรดเข้าสู่ระบบอีกครั้งหรือรีเฟรชหน้าจอ
追加しようとしたユーザがGuardiaシステムで存在している=มีผู้ใช้นี้อยู่แล้วในระบบ Guardia
追加しようとしたユーザがGuardiaシステムで存在していない=ไม่พบผู้ใช้นี้ในระบบ Guardia
アクション=การดำเนินการ
依頼者=ผู้ขอ
富士フイルムビジネスイノベーション=ฟูจิฟิล์ม บิสซิเนส อินโนเวชั่น
資産管理番号=หมายเลขสินทรัพย์ของผู้ใช้
案件ID=รหัสข้อตกลง
案件名=ชื่อเรื่องโปรเจค
レベル１表示名=ชื่อที่แสดง ระดับ 1
テナントを選択してください。=เลือกโปรเจค
テナント名=ชื่อโปรเจค
最終登録日=วันที่ลงทะเบียนล่าสุด
{ target }を削除しますか？=คุณต้องการจะลบ {target} หรือไม่
削除=ลบ
ユーザが存在しません。他のユーザでログインするか、管理者に連絡してください。=ไม่พบผู้ใช้ โปรดเข้าสู่ระบบในฐานะผู้ใช้รายอื่น หรือติดต่อผู้ดูแลของคุณ
{0}文字以内で入力してください。=ป้อนอักขระไม่เกิน {0} ตัว
{0}以下の数値を入力してください。=ป้อนค่าตัวเลขไม่เกิน {0}
{0}は必須項目です。=จำเป็นต้องระบุ {0}
読み込み中…=กำลังโหลด...
キャンセル=ยกเลิก
関連サービスは存在しません=ไม่พบบริการที่เกี่ยวข้อง
レポートは存在しません=ไม่พบรายงาน
ユーザーは存在しません=ไม่พบผู้ใช้
お知らせは存在しません=ไม่พบประกาศ
メーターは存在しません=ไม่พบมิเตอร์
ユーザが存在しません。他のユーザでログインするか、管理者に連絡してください。=ไม่พบผู้ใช้ โปรดเข้าสู่ระบบในฐานะผู้ใช้รายอื่น หรือติดต่อผู้ดูแลของคุณ
案件が既に削除されていますので、ログインできません。=ไม่สามารถเข้าสู่ระบบได้เนื่องจากเคสถูกลบไปแล้ว
交換メッセージが表示された場合は消耗品依頼画面でご依頼をお願いします=เมื่อมีข้อความแจ้งให้เปลี่ยนปรากฏขึ้น โปรดดำเนินการส่งคำขอดังกล่าวบนหน้าจอคำขอวัสดุสิ้นเปลือง
内容入力後、「内容を確認する」をクリックしてください。\r\n内容確認のために、お電話をさせていただく場合がありますが、ご了承ください。=หลังจากที่ได้ป้อนรายละเอียดแล้ว ให้คลิก ยืนยัน\r\nเราอาจโทรหาคุณเพื่อตรวจสอบรายละเอียด
* ヘルプデスクサービス提供時間外にいただいたご依頼は、翌稼働日の対応とさせていただきます。\r\n （定時外保守契約を締結されており、お急ぎの場合は、専用窓口をご確認ください。）=* คำขอต่างๆ ที่ระบบได้รับในช่วงนอกเวลาทำการของบริการให้ความช่วยเหลือจะได้รับการจัดการในวันทำการถัดไป\r\n(ในกรณีที่เร่งรีบและคุณมีสัญญาการบำรุงรักษาแบบนอกเวลาทำการ กรุณาติดต่อไปยังเว็บไซต์การสนับสนุนที่จัดสรรไว้โดยเฉพาะ)
* ヘルプデスクサービス提供時間外にいただいたお問い合わせは、翌稼働日の対応とさせていただきます。=* การสอบถามต่างๆ ที่ระบบได้รับในช่วงนอกเวลาทำการของบริการให้ความช่วยเหลือจะได้รับการจัดการในวันทำการถัดไป
以下の依頼内容を入力後、記入済みの出力機器 MACD依頼書を添付して「内容を確認する」をクリックしてください。\r\n内容確認のために、お電話をさせていただく場合がありますが、ご了承ください。=โปรดคลิก 'ยืนยัน' เพื่อส่งคำขอ หากจำเป็นทีมสนับสนุนของเราจะติดต่อคุณกลับไป ขอขอบพระคุณ
* ヘルプデスクサービス提供時間外にいただいたご依頼は、翌稼働日の対応とさせていただきます。=* คำขอต่างๆ ที่ระบบได้รับในช่วงนอกเวลาทำการของบริการให้ความช่วยเหลือจะได้รับการจัดการในวันทำการถัดไป