ECO推進=โปรแกรมรักษ์โลก
エグゼクティブ=ผู้บริหาร
ECO推進（全社）=โปรแกรมรักษ์โลกตามออฟฟิศ
集計期間：=ระยะเวลา
電子化状況=การแปลงเป็นระบบดิจิทัล
ECO推進率=อัตราสำหรับโปรแกรมรักษ์โลก
全社平均=ค่าเฉลี่ยของบริษัท
他社平均=ค่าเฉลี่ยของคู่แข่ง
オフィス平均=ค่าเฉลี่ยของออฟฟิศ
プリント削減率=อัตราลดการพิมพ์
コピー削減率=อัตราลดการทำสำเนา
ファクス削減率=อัตราลดการแฟกซ์
ECO貢献度=ร่วมโปรแกรมรักษ์โลก
紙削減枚数=อัตราลดการใช้กระดาษ
枚=แผ่น
削減電力量=อัตราลดการใช้พลังงาน
削減CO2=อัตราลดการปล่อย CO2
常緑樹換算=ปกป้องต้นไม้
本=ต้น
バブルの大きさは削減枚数です。=ขนาดวงกลมแสดงถึงจำนวนภาพ
オフィス別=ตามออฟฟิศ
月次推移=ตามเดือน
電子化比率=การแปลงเป็นระบบดิจิทัล
まとめて1枚/両面率=อัตราลดของแผ่นกระดาษ
選択したオフィス=ออฟฟิศที่เลือก
オフィスごとのプリント削減率=อัตราลดการใช้กระดาษตามออฟฟิศ
全社ランキング=การจัดลำดับ
〇位(〇オフィス中)=○ (จาก ○ ออฟฟิศ)
〇内プリント削減率ランキング=การจัดลำดับอัตราลดการใช้กระดาษใน ○
〇〇更新=อัปเดต ○○
あなた=คุณ
印刷ジョブ取得ツール=เครื่องมือเรียกข้อมูลงานพิมพ์
ダウンロード=ดาวน์โหลด
インストール状況=สถานะการติดตั้ง
Windowsログインユーザー名=ชื่อผู้ใช้ Windows
ADユーザー名=ชื่อผู้ใช้ AD
PC名=ชื่อพีซี
ツールバージョン=รุ่นเครื่องมือ
最終更新日=อัปเดตล่าสุด
テンプレート=เทมเพลต
アップロード=อัปโหลด
メンテナンス=การบำรุงรักษา
ユーザーリスト登録=ลงทะเบียนรายชื่อผู้ใช้
登録状況=สถานะการลงทะเบียน
ジョブID=รหัสงาน
登録者=ลงทะเบียนโดย
ファイル名=ชื่อไฟล์
登録結果=ผลลัพธ์
登録日時=วันที่และเวลาที่ลงทะเบียน
エラー詳細=รายละเอียดข้อผิดพลาด
詳細=รายละเอียด
行番号=แถว
ユーザーID=รหัสผู้ใช้
メールアドレス=ที่อยู่อีเมล
表示名=ชื่อที่แสดง
組織名=องค์กร
エラー内容=คำอธิบาย
ECO推進ユーザー所属設定=โปรแกรมรักษ์โลก - การกำหนดค่าสำหรับผู้ใช้
ユーザー所属登録=ลงทะเบียนออฟฟิศ
ユーザー=ผู้ใช้
ユーザー追加=เพิ่มผู้ใช้
ユーザー削除=ลบผู้ใช้
入力内容=ข้อมูลที่ป้อน
ユーザー選択=เลือกผู้ใช้
所属済みユーザーを含む=รวมผู้ใช้ที่กำหนด
ECO推進（部門）=กรีนนิ่งโดยออฟฟิศ
ECO推進（個人）=การทำให้เป็นสีเขียวตามรายบุคคล
先月より改善傾向です=ดีกว่าเดือนที่แล้ว
先月より悪化傾向です=แย่กว่าเดือนที่แล้ว
電子ファイル比率=อัตราส่วนไฟล์อิเล็กทรอนิกส์
スキャン比率=อัตราส่วนการสแกน
ペーパーレス受信比率=อัตราส่วนการรับแฟกซ์แบบไร้กระดาษ
成功=ความสำเร็จ
エラー=ข้อผิดพลาด